ABO	ABO
ABOKADO	ABOKADO
ABOGADO	ABOGADO
ABOT	ABOT
ABRIL	ABRIL
AKIN	AKEN
AKO	AKO
ADIYOS	ADIOS
AGAW	AGAW
AGOSTO	AGOSTO
ALAKDAN	ALAKRAN
AHENTE	AHINTI
ALAHAS	ALAHAS
ALALAY	ALALAY
ALAMBRE	ALAMBRI
ALANGALANG	ALANGALANG
ALBULARYO	ALBOLARIO
ALBUM	ALBOM
ALKANSIYA	ALKANSIA
ALKETRAN	ALKITRAN
ALIMANGO	ALIMANGO
ALMIROL	ARMIDOL
ALON	ALEN
ALUGBATI	ALOGBATI
AMA	AMA
AMIHAN	AMIAN
AMIN	AMEN
AMpon	AMPon
ANAY	ANAY
ANDAMYO	ANDAMIO
ANIM	ANEM
ANINO	ANINO
ANG	ANG
ANGKIN	ANGKEN
ANGHIT	ANGit
ANO	ANONO
ANOD	ANOD
ANONAS	ANONAS
ANTINGANTING	ANTINGANTING
APARADOR	APARDAOR
APAT	APAT
APDO	APDO
APELIEDO	APILIDO
APO	APO
APOG	APOG
ARAL	ADAL
ARARO	ARADO
ARAW	ADLAW
ARAWARAW	ADLAWADLAW
ARKO	ARKO
ARMAS	ARMAS
ARTISTA	ARTISTA
ASAWA	ASAWA
ASENSO	ASINSO
ASERO	ASIRO
ASIKASO	ASIKASO
ASIM	ASLEM
ASIN	ASIN
ASO	ASO
ASOGE	ASOGI
ASPALTO	ISPALTO
ASUKAL	ASUKAR
ASUNTO	ASONTO
ATAY	ATAY
ATIN	ATEN
ATIP	ATEP
ATIS	ATIS
ATRAS	ATRAS
ATRASADO	ATRASADO
ATSARA	ATSARA
ATSUETE	SIWITI
AWAT	AWAT
AYUDA	AYODA
	
BABAE	BABAI
BABAW	BABAW
BABOY	BABOY
BAKA	BAKA
BAKANTE	BAKANTI
BAKASYON	BAKASION
BAKLA	BAKLA
BAKUNA	BAKONA
BAKYA	BAKYA
BADMINTON	BADMINTON
BALITA	BARITA
BALO	BALO
BALOTA	BALOTA
BALSA	BALSA
BALSE	BALSI
BALUTAN	BALOTAN
BALIENA	BALINA
BANAK	BALANAK
BANDA	BANDA
BANDANA	BANDANA
BANDEHA	BANDIHA
BANDILA	BANDIRA
BANIG	BANIG
BANGA	BANGA
BANGKERO	BANGKIRO
BANGKETA	BANGKITA
BANGKO	BANGKO
	
BANLAG	BANLAG
BANLAW	BONLAW
BANTAY	BANTAY
BANTOG	BANTOG
BANYO	BANYO
BAON	BALON
BAPOR	BAPOR
BARA	BARA
BARAHA	BARAHA
BARBERO	BARSIRO
BARKO	BARKO
BARILES	BARILIS
BARNIS	BARNIS
BASA	BASA
BASABASA	BASABASA
BASKET	BASKIT
BASKETBOL	BASKITBOL
BASO	BASO
BASTIDOR	BASTIDOR
BASTON	BASTON
BASYO	BASYO
BATA	BATA
BATERYA	BATIRIA
BATO	BATO
BATO_BALANI	BATOBALANI
BATUTA	BATUTA
BATYA	BATYA
BAUL	BAUL
BAWAL	BAWAL
BAYABAS	BAYABAS
BAYAD	BAYAD
BAYAS	BAYAS
BAYAW	BAYAW
BAYAWAK	BAYAWAK
BAYO	BAYO
BAYONG	BAYONG
BELO	BILO
BENDA	BINDA
BENTILADOR	BILINTADOR
BERDE	BIRDI
BERSO	BIRSO
BESES	BISIS
BESBOL	BISBOL
BETERANO	BITIRANO
BIBINGKA	BIBINGKA
BIBLIYA	BIBLIA
BIKO	BIKO
BIGAS	BEGAS
BIGAT	BEGAT
BIGKIS	BEGKES
BIHAG	BIAG
BIHIRA	BIHIRA
BIHON	BIHON
BIIK	BEYEK
BILANG	BILANG
BILAS	BILAS
BILIN	BILIN
BILING	BIRING
BILOG	BILOG
BINATOG	BINATOG
BINHI	BINI
BINLID	BINLED
BINTANA	BINTANA
BINYAG	BONYAG
BIRHEN	BIRHIN
BOTA	BOTA
BOTANTE	BOTANTI
BOTO	BOTO
BRASO	BRASO
BRILYANTE	BRILIANTI
BUBO	BOBO
	
BUKANA	BOKANA
BUKAYO	BOKAYO
	
BUKBOK	BOKBOK
BUKO	BOKO
BUKOL	BOKOL
BUUGAW	BOGAW
BUGTONG	BOGTONG
BUHAWI	BOAWI
BUHOK	BOOK
BULA	BORA
BULAK	BORAK
BULADOR	BOLADOR
BULKAN	BOLKANO
BULIK	BOLIK
	
BULOK	LOBOK
BULSA	BOLSA
BUMBERO	BOMBIRO
BUNGA	BONGA
BUNGISNGIS	BONGISNGIS
BUNGGO	BONGO
BUNOT	BONOT
BURDA	BORDA
BUSAL	BOSAL
BUSOG	BOSOG
BUSON	BOSON
BUTETE	BOTITI
BUTONES	BOTINIS
BUWAN	BOLAN
BUWAYA	BOAYA
BUWENAS	BOWINAS
BUWIG	BOLIG
BUYU	BOYO
	
KAARAWAN	KAADLAWAN
KABATAAN	KABATAAN
KABAYO	KABAYO
KABIT	KABIT
KAKAW	KAKAW
KADENA	KADINA
KADYOS	KADYES
KAGABI	KAGABI
KAGAT	KAGAT
KAHAPON	KAAPON
KAHERA	KAHIRA
KAHOY	KAOY
KAIN	KAEN
KAINAN	KAENAN
KAINGIN	KAINGIN
KALABASA	KALABASA
KAMA	KAMA
KAMALIG	KAMALIG
KAMANDAG	KAMANDAG
KAMANTIGE	KAMANTIGI
	
KAMAO	KAMAO
KAMATAYAN	KAMATAYAN
KAMATIS	KAMATIS
KAMBING	KAMBING
KAMI	KAMI
KAMIAS	KAMIAS
KAMISETA	KAMISITA
KAMISON	KAMISON
KAMOT	KALOT
KAMOTENGBAGING	KAMOTINGBALAGEN
KAMOTENGKAHOY	KAMOTINGKAOY
KAMPANA	KAMPANA
KAMPANARYO	KAMPANARYO
KAMPANYA	KAMPANIA
KAMPO	KAMPO
KANAL	KANAL
KANDADO	KANDADO
KANDIDATO	KANDIDATO
KANDILA	KANDILA
KANGKONG	TANGKONG
KANGINA	KAINA
KANIN	KANEN
KANTA	KANTA
KANTERO	KANTIRO
KANTIYAW	KANTIAO
KAPATAS	KAPATAS
KAPE	KAPI
KAPIT	KAPET
KAPON	KAPON
KAPOTE	KAPOTI
KAPRITSO	KAPRITSO
KAPUS	KAPOS
KARATULA	KARATOLA
KARERA	KARIRA
KARETILYA	GARATILIA
KARNE	KARNI
KASAL	KASAL
KASALANAN	KASALANAN
KASALO	KASARO
KASANGKAPAN	KASANGKAPAN
KASOY	KASOY
KASTILA	KASTILA
KASULUTAN	KASOLATAN
KATALA	KATALA
KATAM	KATAM
KATAPUSAN	KATAPOSAN
KATRE	KATRI
KAWA	KAWA
KAWAN	KAWAN
KAWAYAN	KAWAYAN
KAWIL	KAWIL
KAYAS	KIAS
KAYO	KAMO
KENDI	KINDI
KESO	KISO
KIDLAT	KILAT
KILALA	KILALA
KINGKE	KINGKI
KISAME	KISAMI
KLASE	KLASI
KLIMA	KLIMA
KLINIKA	KLINIKI
KOGON	KOGON
KOLEHIYO	KOLIHIYO
KOMPANYA	KOMPANIA
KONSEHAL	KONSIHAL
KONTRATA	KONTRATA
KOPYA	KOPIA
KORONA	KORONA
KORPORASYON	KORPORASYON
KOTSE	KOTSI
KRIMINAL	KRIMINAL
KRISIS	KRISIS
KRISTO	KRISTO
KRUS	KROS
KUBYERTOS	KORBITOS
KUKO	KOKO
KUDKURAN	KODKODAN
KULANG	KORANG
KULATA	KOLATA
KOLITIS	KOLITIS
KULONG	KOLONG
KULUNGAN	KOLONGAN
KULUGO	KALONGGO
KUMBENTO	KOMBINTO
KUMPIL	KOMPIL
KUMPISAL	KOMPISAR
KUMPIT	KOMPIT
KUMPUNI	KOMPONIR
KUMUSTA	KOMOSTA
KUNSUMISYON	KONSIMISION
KUNSUMO	KONSOMO
KUPAS	KOPA
KURA	KORA
KURBATA	KORBATA
KURDON	KORDON
KUROT	KODOT
KURTINA	KORTINA
KUSKOS	KOSKOS
KUSINA	KOSINA
KUTA	KOTA
KUTING	KOTI
KUTSARA	KOTSARA
KUTSILYO	KOTSILIO
KUTSINTA	KOTSINTA
KUWADRADO	KOWADRADO
KUWARTA	KOWARTA
KUWARTO	KOWARTO
KUWELYO	KOWILIO
KUWENTA	KOWINTA
KULAP	KULAP
KUWERDAS	KOWIRDAS
KUWINTAS	KOLINTAS
KUWITIS	KOWITIS
KUYUMAD	KAYMAD
	
DAAN	DAAN
DAKIP	DAKEP
DAGAT	DAGAT
DAGIT	DAGIT
DAHANDAHAN	DANDAN
DAHILAN	DAILAN
DAHON	DAON
DAIG	DAEG
DAING	DAING
DALA	DARA
DALAGA	DARAGA
DALAHIN	DARAEN
DALAWA	DARWA
DALDAL	DALDAL
DALI	DALI
DATI	DATI
DAMA	DAMA
DAPA	DAPA
DAPAT	DAPAT
DAPLIS	DAPLIS
DAUSDUS	DALOSDOS
DAYA	DAYA
DAYAMI	DAGAMI
DELIKADO	DILIKADO
DEMANDA	DIMANDA
DEMOKRASYA	DIMOKRASIA
DENTISTA	DINTISTA
DEPOSITO	DIPOSITO
DIKIT	DEKET
DIDAL	DIDAL
DILA	DILA
DILAW	DOLAW
DILIM	DELEM
DINGDING	DINGDING
DIYOS	DIOS
DIPA	DEPA
DISYEMBRE	DISIMBRI
DIYAN	DIAN
DIYANITOR	DIANITOR
DOBLE	DOBLI
DRAYBER	DRAIBER
DOMINO	DOMINO
DOKTOR	DOKTOR
DUDA	DODA
DUGO	DOGO
DUMALAGA	DOMARAGA
DURA	DORA
DUWENDE	DOWINDI
DUYAN	DOYAN
	
EBANGHELYO	IBANGHILIO
EBIDENSIYA	IBIDINSIA
EKLIPSE	INGKLIPSI
EKSAKTO	IGSAKTO
EDAD	IDAD
EHE	IHI
EHERSISYO	IRSISIO
ELEKSIYON	ILIKSIYON
ELEPANTE	ILIPANTI
EMBARGO	IMBARGO
EMBUDO	IMBODO
EMPATSO	IMPATSO
ENERO	INIRO
ENGKANTADO	INGKANTADO
ENGKANTO	INGKANTO
ENSAYO	INSAYO
ENTABLADO	INTABLADO
EPEKTO	IPIKTO
EPIDEMIYA	IPIDIMIA
EROPLAN	IROPLANO
ESKANDALO	ISKANDALO
ESKUWALA	ISKOWALA
ESKUWELA	ISKOWILA
ESKUWELAHAN	ISKOWILAN
ESPERMA	ISPIRMA
ESPADA	ISPADA
ESPIRITU	ISPIRITO
ESPIYA	ISPIA
ESPONGHA	ISPONGHA
ESPOSA	ISPOSA
ESPOSO	ISPOSO
ESTANTE	ISTANTI
ESTAPA	ISTAPA
ESTASYON	ISTASION
ESTATUWA	ISTATOWA
ESTRANGHERO	ISTRANHIRO
ESTUDYANTE	ISTODIANTI
	
GAAN	AGAN
GAAS	GAAS
GABI	GABI
GALANG	GALANG
GALAPONG	GALAPONG
GALUNGGONG	GALONGGONG
GALYETAS	GALITAS
GAMIT	GAMIT
GANA	GANA
GANANSIYA	GANANSIA
GANSAL	GANSAL
GANSA	GANSA
GANTSILYO	GANSILIO
GAPUS	GAPOS
GARAHE	GARAHI
GASPANG	GASPANG
GASTA	GASTA
GASTADOR	GASTADOR
GASTOS	GASTOS
GATA	GATA
GATAS	GATAS
GIBA	GEBA
GIIK	GYEK
GILID	KILID
GILING	GILING
GILINGAN	GILINGAN
GINISA	GINISA
GITARA	GITARA
GIYA	GIYA
GIYERA	GIRA
GOBYERNO	GOBIRNO
GOBERNADOR	GOBIRNADOR
GRABA	GRABA
GRIPO	GRIPO
GUBAT	GEBA
GUHIT	KORIT
GULAY	GOLAY
GULO	GOLO
GULONG	GOLONG
GUMAMELA	GOMAMILA
GUNTING	GONTING
GUTOM	GETEM
GUWANG	GAWANG
GUWANTES	GOWANTIS
GUYABANO	GOYABANO
	
HABAGAT	ABAGAT
HAKOT	AKOT
HAGDAN	AGDAN
HALAKHAK	ALAKAK
HALANG	ARANG
HALIK	AREK
HALIGI	ARIGI
HALIMBAWA	ALIMBAWA
HALO	ALO
HALOS	ALOS
HAMBOG	AMBOG
HAMOG	NAMOG
HAMON	HAMON
HANGIN	ANGIN
HAPDI	APDI
HAPLOS	APROS
HAPON	APON
HARANA	ARANA
HARI	ADI
HARINA	ARINA
HASANG	ASANG
HATID	ATED
HAYOP	AYEP
HENERAL	HIINIRAL
HERINGGILYA	IRINGGILIA
HIGA	INGGA
HIGAAN	IRINGGAN
HIGANTE	IGANTI
HIGOP	IGEP
HILAW	ILAW
HIMAS	IMAS
HINDI	INDI
HIPAG	IPAG
HITO	ITO
HIYA	EYA
HUBAD	OBAD
HUKOM	OKOM
HUGAS	OGAS
HUGOT	OGOT
HULI	ORI
HULMAHAN	ORMAN
HULOG	OLOG
HULYO	HOLYO
HUNI	ONI
HUNYO	HONTO
HUSGA	HOSGA
HUSTISYA	HOSTISYA
HUWEBES	HOWIBIS
	
IBA	IBA
IBABA	IBABA
IBABAW	IBABAW
IKAW	IKAW
IKULA	IKOLA
IHIP	EYEP
ILADLAD	ILADLAD
ILALIM	IDALEM
ILING	ILENGILENG
ILONG	IRONG
INA	INA
INIT	INIT
INOM	INEM
INSIYENSO	INSINSI
INSPIRASYON	INSPIRASYON
INSULTO	INSOLTO
INTINDI	INTINDI
INYO	INDO
IPA	OPA
IPIT	IPIT
ISA	ISARA
ISDA	ISDA
ISIP	ISIP
ITLOG	ITLOG
ITSURA	ITSORA
IYO	IMO
	
LABABO	LABABO
LABATIBA	LABATIBA
LABAHA	LABAHA
LABANOS	RABANOS
LAGARI	LAGADI
LAGPAK	LAGPAK
LALAKI	LALAKI
LALIM	DALEM
LAMIG	RAMIG
LAMOK	NAMOK
LANGAW	LANGAW
LANGKA	LANGKA
LANGIT	LANGIT
LANSA	LANGSA
LAPAD	LAPAD
LAPIS	LAPIS
LAPIT	RAPIT
LARAWAN	LADAWAN
LASO	LASO
LASON	LASON
LATA	LATA
LATIK	LATIK
LAWAY	LAWAY
LAWIN	LAWIN
LAYAW	LAYAW
LAYAS	LAYAS
LAYO	RAYE
LEEG	LIEG
LETRA	LITRA
LIBING	LEBENG
LIBINGAN	LEBENGAN
LIBO	RIBO
LIBOT	LIBOT
LIBRE	LIBRI
LIBRO	LIBRO
LIKO	KILO
LIKOD	LIKOD
LIHA	LIHA
LILA	LILA
LILIP	LILIP
LIMA	LIMA
LIMAS	LIMAS
LILIM	ILEMEM
LIMOS	LIMOS
LINGA	LENGA
LINYA	LINYA
LINTA	LINTA
LIPAD	LEPAD
LIPAS	LEBAS
LISA	LESA
LISENSIYA	LISINSIA
LISTA	LISTA
LITSON	LITSON
LITAW	LOTAW
LOOK	LEK
LOSA	LOSA
LUGAR	LOGAR
LUKSA	LOKSA
LUGAW	LOGAW
LUGI	LOGI
LUHA	LOA
LUHOD	LOOD
LUMOT	LOMOT
LUNES	LONIS
LUNO	LONO
LUSONG	LOSONG
LUYA	LOYA
MAAGA	MAAGA
MAANTA	MAANTA
MAASIM	MAASLEN
MAAYOS	MAAYOS
MABABA	MABABA
MABABAW	MABABAW
MABAHO	MABAO
MABIGAT	MABEGAT
MAKINA	MAKINA
MAKINILYA	MAKINAILYA
MAKINISTA	MAKINISTA
MADALI	MADILI
MADILIM	MADELEM
MADRE	MADRI
MAESTRA	MAISTRA
MAESTRO	MAISTRO
MAGAAN	MAAGAN
MAGAMA	MAGAMA
MAGASAWA	MAGASAWA
MAGASPANG	MAGASPANG
MAGHAPON	MAGAPON
MAGINA	MAGINA
MAHAL	MAAL
MAIS	MAIS
MALAGKIT	MARAGKET
MALAMIG	MARAMIG
MAALAPAD	MALAPAD
MALASADO	MALASADO
MALAYO	MARAYE
MALETA	MALITA
MALINAMNAM	MANANAM
MALUNGGAY	BALONGGAY
MAMON	MAMON
MANGKOK	MANGKOK
MANGGA	POMANGGA
MANI	MANI
MANIPIS	MANIPIS
MANOK	MANOK
MANTEL	MANTIL
MANTIKA	MANTIKA
MANTIKILYA	MATIKILYA
MANTSA	MANSA
MANUGANG	MANOGANG
MAPA	MAPA
MAPAIT	MAPAIT
MARMOL	MARMOL
MARSO	MARSO
MARTES	MARTIS
MARTILYO	MARTILIO
MARTSA	MARTSA
MARUPOK	MATOPOK
MASA	MASA
MASAKIT	MASAKIT
MASKADA	MASKADA
MASKARA	MASKARA
MASINSIN	MASENSEN
MASYADO	MASYADO
MATA	MATA
MATAAS	MATAAS
MATABIL	MATABIL
MATAMIS	MATAMIS
MATIGAS	MATEGAS
MATRIKULA	MATRIKOLA
MATRIS	MATRIS
MAYA	MAYA
MAYABONG	MARABONG
MAYO	MAYO
MEKANIKO	MIKANIKO
MEDALYA	MIDALYA
MEDYAS	MIDYAS
METRO	MITRO
MIKROBYO	MIKROBYO
MILYON	MILYON
MILYONARYO	MILYONARYO
MINA	MINA
MININDAL	MIRINDAL
MINTIS	MINTIS
MISA	MISA
MISTISA	MISTISA
MITING	MITING
MINUTO	MINOTO
MIYERKULES	MIRKOLI
MODA	MODA
MONUMENTO	MANIOMINTO
MUHON	MOHON
MUMO	MOMO
MULTA	MOLTA
MUNISIPYO	MONISIPYO
MUSIKO	MOSIKO
MUSTASA	MOSTASA
NAKITA	NAKITA
NAHIYA	NAEYA
NAHULI	NAORI
HANULOG	NAOLOG
NAIPIT	NAIPIT
NAISIP	NAISIP
NALAMAN	NAELAMAN
NALUGI	NALOGI
NANA	NANA
NANAY	NANAY
NILAGA	LINAGA
NERBIYOS	NIRBYOS
NILOKO	INLOKO
NINANG	NINANG
NINONG	NINONG
NIYOG	NIYOG
NGALAN	ARAN
NGANGA	NGANGA
NGILO	NGILO
NGIPIN	IPIN
NGISNGIS	NGISNGIS
NGIWI	KIWI
NGUDNGUD	NFEYENGETE
NGUYNGUY	
NUMIROH	NOMIRO
OBRERO	OBRIRO
OBISPO	OBISPO
OKRA	OKRA
OKYUBRE	OKTOBRI
OPISINA	OPISINA
ORAS	ORAS
ORASYON	ORASION
OREGANO	ORIGANO
ORIHINAL	ORIHINAL
OSPITAL	OSPITAL
	
PABAYA	PABAYA
PABAYAAN	PABAYAN
PABIGAT	PABEGAT
PABRIKA	PABRIKA
PAGKAIN	PAGKAEN
PAKIMKIM	PAKEMKEM
PAKINABANG	PAKINABANG
PAKPAK	PAKPAK
PAKSIW	PAKSIO
PAGADOR	PAGADOR
PAGKAIN	PAGKAEN
PAGKATAO	PAGKATAO
PAGKATAPOS	PAGKATAPOS
PADER	PADIR
PAGI	PAGI
PAHA	PAHA
PAHID	PAID
PAIT	PAIT
PALA	PALA
PALAKOL	PARAKOL
PALANGGANA	PLANGGANA
PALARA	PALARA
PALASPAS	PALASPAS
PALASYO	PALASIO
PALAY	PARAY
PALENGKE	PALINGKI
PALIKPIK	PALIKPIK
PALIGO	PARIGOS
PALITO	PALITO
PALO	PALO
PALTIK	PALTIK
PALUPALO	PALOPALO
PALYA	PALYA
PAMBIHIRA	PAMBIHIRA
PAMILYA	PAMILIA
PAMINTA	PIMINTA
PANA	PANA
PANADERO	PANADIRO
PANADERYA	PANADIRYA
PANDAK	PANDAK
PANDAN	PANGDAN
PANGA	PANGA
PANGAKO	PANGAKO
PANGANAY	PANGANAY
PANGGABI	PANGGABI
PANSIT	PANSIT
PANTALAN	PANTALAN
PANYO	PANYO
PAPA	PAPA
PAPEL	PAPIL
PARA	PARA
PARADA	PARADA
PAREHO	PARIHO
PARI	PADI
PAOS	PAOS
PARILYA	PARILIA
PAROLA	PAROLA
PASA	PASA
PASAHERO	PASAHIRO
PASAN	PASAN
PASKO	PASKO
PASO	PASO
PASTOL	PASTOR
PASYAL	PASYAr
PATAG	PATAG
PATANI	PATANI
PATATAS	PATAAS
PATAWAD	PATAWAD
PATAY	PATAY
PATI	PATI
PATIS	PATIS
PATO	PATO
PATRON	PATRON
PATUWAD	PATOWAD
PAWIKAN	PAWIKAN
PAWID	PAOD
PAYONG	PAYONG
PEBRERO	PIBRIRO
PEKAS	PIKAS
PEDIDO	PIDIDO
PELIKULA	PILIKOLA
PERLAS	PIRAS
PERO	PIRO
PETRO	PITROLIO
PETSA	PITSA
PETSAY	PITSAY
PIKNIK	PIKNIK
PIKO	PIKO
PIKO	TIKO
PIKOT	PIKOT
PIGA	PEGA
PIGSA	PEGSA
PIHIT	PIRIT
PILI	PILI
PILIIN	PILIEN
PINGGA	PINGGA
PINGGAN	PINGGAN
PINGPONG	PINGPONG
PINO	PINO
PINTURA	PINTORA
PINYA	PINYA
PIRASO	PIDASO
PIRING	PERENG
PIRMA	PIRMA
PISIP	PISIL
PISNGI	PISNGI
PISO	PISO
PISON	PISON
PISTA	PISTA
PITAKA	PITAKA
PITADA	PITADA
PITO	PITO
PITSEL	PITSIL
PITSO	PITSO
PIYANSA	PIYANSA
PIYE	PIYI
PIYON	PIYON
PLAKA	PLAKA
PLANETA	PLANITA
PLANO	PLANO
PLANTSA	PLANSA
PLASA	PLASA
PLASTIK	PLASTIK
PLEMA	PLIMA
PODER	PODER
PONDO	PUNDU
PORMAL	PORMAL
POSPORO	POSPORO
PRASKO	PRASKO
PREMYO	PRIMYO
PRINSIPE	PRINSIPI
PRINSESA	PRINSISA
PRINSIPAL	PRINSIPAL
PRITO	PRITO
PROPETA	PROPITA
PRUSISYON	PROSISYON
PUKYUTAN	POTYOKAN
PUDPOD	PODPOD
PUGA	POGA
PUGAD	POGAD
PUGO	POGO
PUGTO	BOGTO
PUHUNAN	POHONAN
PULA	POLA
PULBOS	POLBOS
PULGADA	POLGADA
PULIDO	POLIDO
PULIS	POLIS
PULISIYA	POLISYA
PULITIKA	POLITIKA
PULITIKO	POLITIKO
PULO	PORO
PULPITO	POLPITO
PULPOL	POLPOL
PULSO	POLSO
PUNAS	PONAS
PUNO	PONO
PUNONGKAHOY	PONOKAOY
PUNSO	PONGSO
PUNTIRYA	PONTIRYA
PUNTOS	PONTOS
PURGATORYO	PORGATORY
PURO	PORO
PUROK	POROK
PUSO	POSO
PUSOD	POSOD
PUSON	POSON
PUSTA	POSTA
PUTA	POTA
PUTAKTI	KOTAPDI
PUTAHE	POTAHI
PUTI	POTI
PUTO	POTO
PUTOL	POTOL
RADYO	RADYO
RANTSO	RANSO
RASPA	RASPA
RASYON	RASYON
RAYUMA	RIYOMA
REBOLBER	RIBOLBER
REKADO	RIKADO
REKLAMO	RIKLAMO
REGALO	RIGALO
REGLA	RIGLA
RELASYON	RILASYON
RELIHIYON	RILIHIYON
RELO	RILOS
RENDA	RINDA
REPINADO	RIPINADO
REPOLYO	RIPOLYO
REPORMA	RIPORMA
REPUBLIKA	RIPOBLIKA
RESETA	RISITA
RESULTA	RISOLTA
RETASO	RITASO
RETIRO	RITIRO
REYNA	RAYNA
RIBON	RIBON
RIMAS	RIMAS
RIMATSE	RIMATSI
RISERBA	RISIRBA
RIPA	RIPA
ROMANSA	ROMANSA
RONDA	RONDA
ROPERO	ROPIRO
ROSARYO	ROSARYO
ROSAS	ROSAS
ROSKAS	ROSKAS
ROTA	ROTA
	
SABA	SABA
SABADO	SABADO
SABAW	SABAW
SABOG	SABOG
SABON	SABON
SAKAY	SAKAY
SAKIT	SAKIT
SAKO	SAKO
SAKOP	SAKOP
SAKSAK	SAKSAK
SAGING	SAGING
SAHA	SAA
SAHIG	SALEG
SALA	SALAS
SALA	SALA
SALA	SARA
SALAAN	SARARAN
SALAMANGKA	SALAMANGKA
SALAMANGKERO	SALAMANGKIRO
SALAMAT	SALAMAT
SALAMIN	SALAMIN
SALBABIDA	SALBABIDA
SALOK	SAROK
SALOT	SAROT
SALPOK	SAMPOK
SALSA	SARSA
SALUBSOB	SALOGSOG
SAMPAGUITA	SAMPAGITA
	SANGA
SANGA	SANGA
SANGAG	SANLAG
SANTO	SANTOS
SAPA	SAPA
SAPATOS	SAPATOS
SARILI	SADILI
SARISARI	SARISARI
SASTRE	SASTRI
SAWALI	SAWALI
SAWSAW	SAWSAW
SAYA	SAYA
SAYANG	SAYANG
SEBO	SIBO
SEKRETA	SIKRITA
SEKRETARYA	SIKRITARYA
SELYO	SILYO
SEMENTO	SIMINTO
SENADO	SINADO
SERMON	SIRMON
SERTIPIKO	SIRTIPIKO
SIBILYAN	SIBILIAN
SIBUYAS	SIBOYAS
SIKO	SIKO
SIKSIK	SEKSEK
SIGARILYO	SIGARILYO
SIGE	SIGI
SIGNOS	SIGNOS
SILANGAN	SIDLANGAN
SILAW	SOLAW
SILBATO	SIRBATO
SILBI	SIRBI
SILID	SELED
SILONG	SILUNGAN
SILYA	SILYA
SIMA	SIMBAHAN
SINANGAG	SANAG
sinangag	SINANLAG
SINDI	SINDI
SINE	SINI
SINELAS	SINILAS
SINEGUWELAS	SIRGOILAS
SINELAS	SINILAS
SINEGUWELAS	SIRGOILAS
SINGA	SENGA
SINGAW	SONGAW
SINGKAMAS	TIKAMAS
SINGKIT	SINGKIT
SINGKO	SINGKO
SINGHOT	SINGOT
SINGSING	SINGSING
SINO	SINO
SINSIN	SENSEN
SINTURON	SINTORON
SIPA	SIPA
SIPER	SIPER
SIPILYO	SIPILYO
SIPON	SIPON
SIPUNIN	SIPONON
SIPSIP	SIPSIP
SIRENA	SIRENA
SISTEMA	SISTEMA
SITAW	SITAW
SOBRE	SOBRE
SOPAS	SOPAS
SORBETES	SORBETES
SUBSOB	SUBSOB
SUBASTA	SUBASTA
SUKI	SUKI
SUKSOK	SUKSOK
SUGAL	SUGAL
SUGALAN	SUGALAN
SUGAROL	SUGAROL
SUGO	SUGO
SUHA	SUHA
SUHAY	SUHAY
SULAT	SULAT
SULO	SULO
SULONG	SULONG
SULSI	SULSI
SULYAP	SULYAP
SUMAN	SUMAN
SUMPA	SUMPA
SUMPONG	SUMPONG
SUNDALO	SUNDALO
SUNDANG	SUNDANG
SUNGAY	SUNGAY
SUNGKA	SUNGKA
SUNOG	SUNOG
SUNTOK	SUNTOK
SUOT	SUOT
SUPOT	SUPOT
SURISO	SURISO
SUROT	SUROT
SUSTANSIYA	SUSTANSIYA
SUSTENTO	SUSTENTO
SUWELAS	SUWELAS
SUWELDO	SUWELDO
SUWERTE	SUWERTE
	
TAAL	TAAL
TAAS	TAAS
TABAKO	TABAKO
TABLA	TABLA
TABANG	TABANG
TABAS	TABAS
TABON	TABON
TAKLOB	TAALEB
TADTAD	TADTAD
TAE	TAE
TAGA	TAGA
TAGINIT	TAGINIT
TAGULAN	TAGULAN
TAHIP	TAHIP
TAINGA	TAINGA
TALABA	TALABA
TALAKITOK	TALAKITOK
TALAGA	TALAGA
TALIM	TALIM
TALONG	TARONG
TAMA	TAMA
TAMAD	TAMAD
TAMBOL	TAMBOL
TAMIS	TAMIS
TANAN	TANAN
TANDA	TANDA
TANDANG	TANDANG
TANGA	TANGA
TANGKE	TANGKE
TANGLAD	TANGLAD
TANIKALA	TANIKALA
TANIM	TANIM
TANSO	TANSO
TAO	TAO
TAPOS	TAPOS
TARANTADO	TARANTADO
TARI	TARI
TASA	TASA
TASTAS	TASTAS
TATAY	TATAY
TAWAD	TAWAD
TAWAG	TAWAG
TAWAS	TAWAS
TELA	TELA
TELEGRAMA	TELEGRAMA
TELEPONO	TELEPONO
TENIS	TENIS
TENYENTE	TENYENTE
TIBAG	TIBAG
TIBAY	TIBAY
TIKET	TIKET
TIGPAS	TIGPAS
TIGAS	TIGAS
TIGIB	TIGIB
TIGRE	TIGRE
TIHAYA	TIHAYA
TIMBANG	TIMBANG
TIMBANGAN	TIMBANGAN
TIMOG	TIMOG
TINAPA	TINAPA
TINAPAY	TINAPAY
TINDA	TINDA
TINDAHAN	TINDAHAN
TINDERA	TINDERA
TINDIG	TINDIG
TINGI	TINGI
TINIK	TINIK
TINIDOR	TINIDOR
TINTA	TINTA
TISES	TISES
TINIDOR	TINIDOR
TINTA	TINTA
TISIS	TISIS
TITULO	TITULO
TIYAN	TIYAN
TIYANI	TIYANI
TIYANGGE	TIYANGGE
TONELADA	TONELADA
TONO	TONO
TORE	TORE
TOSINO	TOSINO
TOYO	TOYO
TRABAHO	TRABAHO
TRAK	TRAK
TRAYSIKIL	TRAYSIKIL
TREN	TREN
TRONO	TRONO
TROPA	TROPA
TROPEDO	TROPEDO
TROSO	TROSO
TSAA	TSAA
TSART	TSART
TSIKO	TSIKO
TSINELAS	TSINELAS
TUBERO	TUBERO
TUBIG	TUBIG
TUBO	TUBO
TUBO	TUBO
TUBO	TUBO
TUKA	TUKA
TUKOD	TUKOD
TUKTOK	TUKTOK
TUKSO	TUKSO
TUGTOG	TUGTOG
TUHOD	TUHOD
TUHOG	TUHOG
TULAD	TULAD
TULAY	TULAY
TULDA	TULDA
TULI	TULI
TULO	TULO
TUMBA	TUMBA
TUNAW	TUNAW
TUNGTONG	TUNGTONG
TUNOG	TUNOG
TUOD	TUOD
TURO	TURO
TURUMPO	TURUMPO
TUSOK	TUSOK
TUTULI	TUTULI
TUWAD	TUWAD
TUWALYA	TUWALYA
	
UBAS	ubas
UBAN	uban
UBI	ubi
UBO	uboh
UBOD	ubod
UBOS	ubos
UGALI	ugali
UGAT	ugat
UHALES	uhales
UHAW	uhaw
UHAY	uhay
ULAN	ulan
ULING	ulig
ULO	uloh
UNAHAN	unahan
UNANO	unanoh
UNAT	unat
UNIPORME	unipormeh
UOD	uod
USA	usah
USISA	usisa
USISERA	usiserah
USISERO	usiseroh
USO	usoh
UTAK	utak
UTANG	utag
UTOUTO	utuuto
UWAK	uwak
UWI	uwi
WAKWAK	wakwak
WALO	waloh
WATAKWATAK	watakwatak
WELGA	welgah
WILI	wilih
WISIK	wisik
YABONG	yabog
YAPAK	yapak
YELO	yeloh
YERO	yeroh
YOYO	yoyoh
YUGYOG	yugyog